..............#.......................................................................................................................................
..............#.......................................................................................................................................
..............#.......................................................................................................................................
..............#.......................................................................................................................................
#####.........#..........................................................................############.................................................
#.............#.......................................................................................................................................
#.............#..................................................................--...................................................................
#.........----#.........................................##########...........................................................................X........
#.............#...............................................................................................################..............---.......
#.............#.....................................................................############......................................................
#..---.....................................#############..............................................................................................
#..................................................................................................................................................---
#...................................---......................................1......................----..............................................
#.......---.............................................................########......................................................................
#........................................---....................................................................................................----..
#.........................................................................................##########........................................--........
......#########.........---..........---..........................................----................................................................
......................................................................................................................................................
...................######......#####.................................................................................................######...........