..............#......................................................................................................................................#
..............#......................................................................................................................................#
..............#......................................................................................................................................#
..1...........#L...L...L...L...L.....................................................................................................................#
#####.........####################......................................................############.................................................#
#.............#......................................................................................................................................#
#.............#..................................................................--..................................................................#
#.........----#.........................................##########...........................................................................X.......#
#.............#...............................................................................................################..............---......#
#.............#.....................................................................############.....................................................#
#..---.....................................#############.............................................................................................#
#..................................................................................................................................................###
#...................................---.............................................................----.............................................#
#.......---.............................................................########.....................................................................#
#........................................---....................................................................................................---..#
#.........................................................................................##########........................................--.......#
......#########.........---..........---..........................................----...............................................................#
.....................................................................................................................................................#
...................######......#####.................................................................................................#################